00000000000000000000
00000000021111111140
11111122220000000000
20000000000000000000
11111111112211111110
00000000000000000010
00000000003111111110
00000000000000000000