00000000000000
00000000000000
00000000000000
00000000000000
00000000000000
00000000000000
00000000000000
00000040000000
XXXXX020XXXXXX
XXXXX020XXXXXX
XXXXX020XXXXXX
XXXXX020XXXXXX
XXXXX020XXXXXX
XXXXX020XXXXXX
XXXXX020XXXXXX
00000011000000
00000001000000
00000001000000
00111111111100
00100001000100
00100001111100
00100001000000
00111111110100
00000010010100
00000030011100
00000000000000
